 	#
W	W 
O	AO 
E	EH 
A	AH 
I	IH 
a	AA 
&	AE 
6	AH 
9I	AY 
OI	OY 
9U	AW 
D	DH 
G	JH 
L	AH L 
M	AH M 
N	NG 
R	ER 
S	SH 
T	TH 
U	UH 
Z	ZH 
b	B 
c	CH 
d	D 
e	EY 
f	F 
g	G 
h	HH 
i	IY 
k	K 
l	L 
m	M 
n	N 
o	O 
p	P 
r	R 
s	S 
t	T 
u	UW 
v	V 
w	W 
y	Y 
z	Z 
~	AH N 