a	ɑ
&	æ
6	ə
9	a
A	ʌ
D	ð
E	ɛ
G	d͡ʒ
I	ɪ
L	l̩
M	m̩
N	ŋ
O	ɔ
R	ɹ̩
S	ʃ
T	θ
U	ʊ
W	w
Z	ʒ
b	b
c	t͡ʃ
d	d
e	e
f	f
g	ɡ
h	h
i	i
k	k
l	l
m	m
n	n
o	o
p	p
r	ɹ
s	s
t	t
u	u
v	v
w	w
y	j
z	z
~	n̩