h	h
&	a
6	ə
9	a
A	u
G	j
L	L
M	M
O	o
R	r
U	u
W	w
Z	g
a	a
b	b
c	c
d	d
f	f
g	ɡ
k	k
l	l
m	m
n	n
o	o
p	p
r	r
s	s
t	t
v	v
w	w
y	y
z	z
S	sh
T	th
D	th
N	ng
~	N
e	ay
E	e
i	ee
I	i
u	u