AH1	ʌ1
AH	ə
UW	u
AO	ɔ
EH	ɛ
IH	ɪ
AA	ɑ
AE	æ
AY	aɪ
OY	ɔɪ
AW	aʊ
DH	ð
JH	d͡ʒ
NG	ŋ
ER	əɹ
SH	ʃ
TH	θ
UH	ʊ
ZH	ʒ
CH	t͡ʃ
EY	e
HH	h
IY	i
OW	o
W	w
B	b
D	d
F	f
G	ɡ
K	k
L	l
M	m
N	n
P	p
S	s
T	t
V	v
Y	j
Z	z
R	ɹ
 	
#	 