a	a
á	A
b	b
c	c
cs	C
d	d
dzs	J
dz	D
e	3
ë	e
é	E
f	f
gy	G
g	g
h	h
i	i
í	I
j	j
k	k
ly	j
l	l
m	m
ny	N
n	n
o	o
ó	O
ö	0
ő	@
ô	@
p	p
qu	kv
r	r
sz	S
s	s
ty	T
t	t
y	j
u	u
ú	U
ü	y
ű	Y
û	Y
v	v
w	v
x	ks
zs	Z
z	z